111111111111111111111111
1E0000000000001C10000C01
111110100100000001001011
111001001010101000100101
1P000000C10C000000000C11
111111111111111111111111